a : এক
aback : বিস্মিত
abandon : ত্যাগ করা
abandoned : পরিত্যক্ত
abandonment : বর্জন
abashed : হতভম্ব
abate : প্রকোপ হ্রাস করা
abatement : কম করা
abbey : মঠ
abbot : মঠের কর্তা
abbreviation : সংক্ষেপ করণ
abbreviations : শব্দসংক্ষেপ
abdicate : অধিকার ত্যাগ করা
abduction : অপহরণ
abed : শয্যাগত
aberrant : বিপদগামী
aberration : আপাত বিচ্যুতি
abeyance : মুলতবি
abhor : ঘৃণাভরে পরিহার করা
abide : মেনে চলা
abiding : মানিয়া চলে এমন
abilities : সামর্থ
ability : ক্ষমতা
abject : হীন
abjection : নীচ বা হীন অবস্থা
abjectly : শোচনীয়ভাবে
ablaze : জ্বলন্ত
able : সক্ষম
ably : যোগ্যতার সহিত
abnormal : অস্বাভাবিক
abnormality : নিয়মের ব্যতিক্রম
abnormally : অস্বাভাবিকভাবে
battle : যুদ্ধ
capable : সক্ষম
